  ############################### ################################################
# #############################                            #######################
#          ###################### ################################################
#### ############################ ################################################
#### ######################                                ######       ##########
#### ####################### ########################################## ##########
#### #######################  ######################################### ##########
####             ########### ########################################## ##########
################                                           ############ ##########
################ ########################### ########################## ##########
################ ########################### #########################  ##########
################ ########################### ######################### ###########
################ ########################### ############# ########### ###########
################ ############                              ########### ###########
################ ############### ######################### ########### ###########
################ ############### ######################### ########### ###########
################ ############### ######################### ########### ###########
#####################                                      ########### ###########
################################ ########### ######################### ###########
################################ ########### #########################  ##########
################################ ########### ########################## ##########
################################ ########### #########################  ##########
########################################                                          
#################################################################################@
